19 10
###################
    ##           ##
### ## ### ##### ##
### ## ######### ##
### ##        ## ##
### ## ######### ##
### ##       ### ##
### ######## ### ##
###          ###   
###################